1111111111111111111111111
1000000000000000000000001
1000000000000000000000001
10000P0000000000000000001
1000000000000E00000000001
1000000000000000000000001
10000000C0000000000000001
1000000000000000000000001
1111111111111111111111111