11111111111111111111111111111111111111111111111111111111111
10000001111111111111111111111111111111111111111111111111111
1PCE0001111111111111111111111111111111111111111111111111111
10000000000000000000000000000000000000000000000000000001111
10000000000000000000000000000000000000000000000000000001111
10000000000000000000000000000000000000000000000000000001111
10000000000000000000000000000000000000000000000000000001111
10000000000000000000000000000000000000000000000000000001111
10000000000000000000000000000000000000000000000000000001111
10000000000000000000000000000000000000000000000000000001111
10000000000000000000000000000000000000000000000000000001111
10000000000000000000000000000000000000000000000000000001111
10000000000000000000000000000000000000000000000000000001111
10000000000000000000000000000000000000000000000000000001111
10000000000000000000000000000000000000000000000000000001111
10000000000000000000000000000000000000000000000000000001111
10000000000000000000000000000000000000000000000000000001111
10000000000000000000000000000000000000000000000000000001111
10000000000000000000000000000000000000000000000000000001111
10000000000000000000000000000000000000000000000000000001111
10000000000000000000000000000000000000000000000000000001111
10000000000000000000000000000000000000000000000000000001111
10000000000000000000000000000000000000000000000000000001111
10000000000000000000000000000000000000000000000000000001111
10000000000000000000000000000000000000000000000000000001111
10000000000000000000000000000000000000000000000000000001111
10000000000000000000000000000000000000000000000000000001111
10000000000000000000000000000000000000000000000000000001111
10000000000000000000000000000000000000000000000000000001111
10000000000000000000000000000000000000000000000000000001111
10000000000000000000000000000000000000000000000000000001111
11111111111111111111111111111111111111111111111111111111111
11111111111111111111111111111111111111111111111111111111111
11111111111111111111111111111111111111111111111111111111111
11111111111111111111111111111111111111111111111111111111111
11111111111111111111111111111111111111111111111111111111111
11111111111111111111111111111111111111111111111111111111111
