11111111111111111111
100000000C0000000001
11111111111111111101
10000000000000000001
10111111111111111111
10000000000000000001
11111111111111111101
1000000000C000000001
10111111111111111111
1C00000000000C000001
11111111111111111101
10000000000000000001
10111111111111111111
1C000000000000000001
11111111111111111101
1C000000000000C00001
10111111111111111111
10000000000000C00001
10000000000C000000P1
11111111111111111111
