1111111111111111111111
1P00000000000000000111
1011111111111111101011
1000000000000000000011
1110111111111111111011
1000100000000000010001
1010111011110101010001
1000000010000000000011
1011100110111011101111
1C000000C0000000000C11
1010111110111111101011
1000000000000000000011
1011111101110111101011
1000000000000000000011
1111100111111111111111
1C0000000000000000E111
1111111111111111111111
